EA ./src/images/wall_textures/text_e.xpm
NO ./src/images/wall_textures/text_n.xpm
SO ./src/images/wall_textures/text_s.xpm
WE ./src/images/wall_textures/text_w.xpm

F 143,169,89
C 161,200,244



111111111111111111111
101000001000000000001
101010101011111110001
1000101000100000D0001
11D110101111101011101
100000101000101000001
1011D1101011101111111
101000001010100000101
101011110010111110101
101010001010100010101
1011101010D0101010101
100000101010001010001
1D1111101011111011101
100000101000100010001
101110101110101D10111
101000100000100010101
101011111D11111010101
100010000000000010001
1010101110111D1111101
1ND000001000000000001
111111111111111111111