EA ./src/images/wall_textures/text_e.xpm
NO ./src/images/wall_textures/text_n.xpm
SO ./src/images/wall_textures/text_s.xpm
WE ./src/images/wall_textures/text_w.xpm

F 143,169,89
C 161,200,244

1111111111111111111111111111111111111111111
1                                         1
1  11111111111111111111111111111111111111 1
1  10000000000000000000000000000000000001 1
1  10000000000000000000000000000000000001 1
1  100000000000000000000N0000000000000001 1
1  10000000000000000000000000000000000001 1
1  10000000000000000000000000000000000001 1
1  11111111111111111111111111111111111111 1
1                                         1
1111111111111111111111111111111111111111111
