EA ./src/images/wall_textures/text_e.xpm
NO ./src/images/wall_textures/text_n.xpm
SO ./src/images/wall_textures/text_s.xpm
WE ./src/images/wall_textures/text_w.xpm

F 143,169,89
C 161,200,244

1111111
100N001
1000001
11D1111
1000001
1111111