NO ./src/images/wall_textures/text_n.xpm
SO ./src/images/wall_textures/text_s.xpm
WE ./src/images/wall_textures/text_w.xpm
EA ./src/images/wall_textures/text_e.xpm

F 143,169,89
C 161,200,244

        1111111111111111111111111
        1000000000110000000000001
        1011000001110000000000001
        1001000000000000000000001
111111111011000001110000000000001
100000000011000001110111011111111
11110111111111011100000010001
11110111111111011101010010001
11000000110101011100000010001
1000000N000000001100000000001
10000000000000001101010010001
1100000111010101111101111000111
11110111 1110100 101111010001
11111111 1111111 111111111111